                  
                  
  /------------\  
  |            |  
  | /--------\ |  
  | |        | |  
  | ,---- ---. |  
  |            |  
  ,------------.  
                  
                  
